1111111111111
1BC1BBBBBBBC1
1BBBB1BBBCBB1
1PBCB1EBBBB11
1111111111111
11B11B1BBB111
11B11B1111B11
111BBB1BBBB11
11111B1B11111
11111B11BBB11
1111111111111
1111111111111
