1111111111111
1PWSWSWSWSCE1
1111111111111
