1111111111111111111111111111111111111111111111111111
1P  1  WWWWWWWWWWW11111   11                       1
1 1    WWWWWWCWWWW111        1 1111111111111111111 1
1         WWWWWWWW111  22   1                    1 1
11                11  2222  1 11111111111111111  1 1
1     22   S      1        11    1            1  1 1
1       S S  2    1 1111111   1111  11111 11 1  1  1
1         22      1 1               11   C  1  1   1
1GGGG             1 1 1 1111 222222 1   1111  11 1 1
1GGGGGGGGGG         1 1             11        1  1 1
1GGGCGGGGGG22     1 1 1111111111111111111111111111 1
1GGGG1GGGGG       1 1                              1
111111111111111111111111 111111111111111111111111111
1                 1         1            C1        1
1                 1 2BB2BB2BB1BB2B2BB2BB2BB1BB2BB2B1
1                 1 B2BB2BB2BBB2BBB2BB2BB2BBB2BBBBB1
1                 11BB2BB2BBBB2BB1BB2BB2BBBB2BB22BB1
1                 1 BBB2BBB2B2BB2BBBB2BBB2B2BB2BB2B1
1        E        1 22BBBB2BB2BBBB22BBBB2BB2BBBBBBB1
1                 1 BB2BB2BBB2BBBBBC2BB2BBB2BBB222B1
1                 1 2BB2BB2BBBB2222BB2BB2BBBBB2BBBB1
1                   BB2B22BBB2BBBBBB2B22BBB2BBB2BB11
1                 1 22BBBBB2BBB2BB22BBBBB2BBBB22BBB1
1                 1    11            11           C1
1111111111111111111111111111111111111111111111111111
