1111111111111
1PWSWSWSWSCE1
111111111111
