1111111111111
10C10000000C1
100001000C001
1P0C01E000001
1111111110111
1101101000111
1101101011011
110000100S011
11111S1011111
111110S000011
1111111111111
1111111111111