11111111111111111111111111
10C10000000C110C10000100C1
100001000C001000001000C001
1P0C01E010000010000E000001
11111111101111111111110111
11S11S1SSSSSSSSS11S1SSS111
11S11S1S11S11S1S11S1S11S11
11SSSS1SSSS11S1SSSS1SSSS11
11111S1S11111S1111S1S11111
11111SSSSSS11S1111SSSSSS11
11111111S1SSSSCSSSSSS11111
11111111111111111111111111