11111111111111111111111111
10C10000000C110C10000100C1
100001000C001000001000C001
1P0C01E010000010000E000001
11111111101111111111110111
11011010000000001101000111
11011010110110101101011011
11000010000110100001000011
11111010111110111101011111
11111000000110111100000011
1111111101SSSSCSSSSSS11111
11111111111111111111111111