1111111111111111111111111111111111111111111111111
1P                         1   1           111111
1   1111 1111     1      2     1 2           C  1
1111111  C  1     111                    2    111
1       2        1                           1  1
1  2222222   11111 2 11111 2222222 22222222  1111
1  2       2       2       2        2           1
1  2 2222222 2222222 2222222 22222  2 22222 11111
1  2 2CS 2 2 2CS 2 2 2CB 2 2 2CB 2  2 2EB 2  1C 1
1  2 222 2 2 222 2 2 222 2 2 222 2  2 222 2  11 1
1  2     2 2     2 2     2 2     2  2     2     1
1  2222222 2222222 2222222 22222222 22222 2     1
1                                               1
1111111111111111111111111111111111111111111111111