1111111111111111111
1PC1L     C      E1
11111 11111111111 1
1                 1
1 111111111111111 1
1                 1
1111111111111111111
