1111111111111111111111111111111111111111111111111
1P                     1 C                      1
1     2222222222222222   222222222222222222     1
1  222222                              2222222  1
1  22                                       22  1
1  2      111111111111  1111111111111        2  1
1  2    111                         111      2  1
1  2    1     11           111        1  2   2  1
1  2    111          22             111      2  1
1  2   11     WWWW    E   WWWW      11111    2  1
1  2    111                         111      2  1
1  2    1     11    WWWW   111        1      2  1
1  2    111                         111  2   2  1
1  2C     111111111111111111111111111        2  1
1  22                                       22  1
1  222222                         C    2222222  1
1     2222222222222222222222222222222222222     1
1C                                             C1
1111111111111111111111111111111111111111111111111
