1111111111111111111111111111111111111111111111111
1P                                             C1
11111111111111111111111111111111111111111111111 1
1C           1                                 C1
1C                                              1
111111111111 111111111111111111111111111111111111
1C  S               S          S      1        C1
1111111111111111111111111111111111111 1 1111111 1
1                      S                   S   C1
1 11111111111111111111111111111111111   111111111
1C                        W     W    111       C1
11       22222222222222      W W       2        1
11       G   G     G   222222222222   22        1
111          G                                 C1
1111111111111111111111111111111111111 11111111111
1              B        E              B        1
1111111111111111111111111111111111111111111111111
