111111111111111111111111111111
1P                          C1
1111111111111111111111111111 1
1C     1                    C1
1C                           1
111111 11111111111111111111111
1C S      S       S    1    C1
1111111111111111111111 1 111 1
1            S            S C1
1 11111111111111111111   11111
1C       S     W W WW 111S  C1
11S 22222      W W    S   S  1
11S G GGGG S     222S  22S   1
111S  GGG  S   S   S   S    C1
1111 1111111111111111 11111111
1221    B     E         B    1
111111111111111111111111111111
