1111111111111111111111111111111111111111111111111
1P                                        B   111
1                        222222222222222     B  1
1                     2222             222 B    1
1                            W W W W            1
1                             W W W W    222    1
11                          W W W W      C22    1
1        2222222222                   222222    1
1     2222          22        2222222222        1
1    22     11111                               1
1            C       11        S                1
1   22   GGGGGGGG       111           S      1111
1    2      GGGGGG     11211                11  1
1    22         111111112121     S       22     1
1  2      1111111    11111111           22  E  C1
1               11                           1 11
1111111111111111111111111111111111111111111111111
