1111111111111111111111111111111111111
1PC E1                              1
111111                              1
1WWWWWWWWGGG                        1
1WWWWWWWWGGG                        1
1WWWWWWWWGGG                        1
1WWWWWWWWGGG                        1
1WWWWWWWWGGG                        1
1WWWWWWWWGGG                        1
1111111111111111111111111111111111111
1W 11W 11W 11W 11W 11W 11W 11W 11W 11
1 G11 G11 G11 G11 G11 G11 G11 G11 G11
1111111111111111111111111111111111111
1111111111111111111111111111111111111
1W 1B 1W 1W 1G 1G 1                 1
1 G1 S1 S1 B1 S1 B1                 1
1111111111111111111111111111111111111
