1111111111111111111111111111111111111
1PEC 1WG1                           1
1111111111111111111111111111111111111
