1111111111111111111111111111111111111
1PC E1W                            G1
1111111111111111111111111111111111111
