1111111111111111111111111111111111111
1PEC 1L S1L W1L B1L G1LLL        GGG1
1111111111111111111111111111111111111
