1111111111111111111111111111111111111
1PC E1                              1
111111                              1
1WW G1                              1
1WW G1                              1
1WW G1                              1
1WW G1                              1
1WW G1                              1
1WW G1                              1
1WW G1                              1
1WW G1                              1
1WW G1                              1
1WW G1                              1
111111                              1
1                                   1
1                                   1
1111111111111111111111111111111111111
